111111111111111
1P00000000000E1
100000000000001
1AA0A0A0A0AA001
1A0A0AA0AA0A001
1C0000000C000C1
111111111111111
