11111111111111111111
1E0000000C0000000C01
10100101011010111001
10111101C10110100101
10100101010010111001
10P000C000000C000001
11111111111111111111
